 UUUUUUUUUUUUUUUUUUUUUUUU
 ........................
 ........................
 .....L..................
 ........................
 ....@.....#..........F..
 ............#...........
 .......#................
 ........................
 ........................
 ........................
 ........................
 ........................