........................................................................
........................................................................
........................................................................
########################################################################
.............................L..........................................
.............................................##.........................
............................@.....#..........F#.........................
....................................#........##.........................
..............................#.........................................
........................................................................
########################################################################
........................................................................
........................................................................
........................................................................