........................................................................
........................................................................
........................................................................
########################################################################
#............................P.........................................#
#............................................##........................#
#...........................@.....#..........F#........................#
#...................................#........##........................#
#.............................#........................................#
#......................................................................#
########################################################################
........................................................................
........................................................................
........................................................................